111111111111111
110C10000000011
110010000000C11
110000111110011
11P0011E0000011
111111111111111
